1111111111111
10000000000C1
100C011111001
1000111E10001
1P00000011111
1111111111111